lemma : [EN] transcript ; [KO] transcript
a : [EN] A h tour. I need a pen to write this down. ; [KO] A 1 1 2 road Ann 뜻을 가진 부담 간사입니다. 뒤에 보는 단어가 다음 소리로 시작할 때 사용해야 예문은 inventories 이것을 받아 적으려면 테니 하나 필요해요. 나는 나의 미래.
an : [EN] A n 하나의 able라는 뜻의 부정관사로 뒤에 오는 단어가 모음소리로 시작할 때 사용합니다. She was to eat on Apple 그녀는 사과 한 개를 먹고 싶어 해요라는 의미네요. ; [KO] 하나의 부정관사로 뒤에 오는 단어가 무음 소리로 시작할 때 사용합니다. 사과 한 개를 먹고 싶어요.
about : [EN] About. What is the book about? ; [KO] About one more stereo. What is the book about?
above : [EN] Above 무엇 무엇보다 위에라는 의미를 가집니다. 예를 들어. The is flying above the building. 헬리콥터가 건물 위를 알고 있어요라는 의미네요. ; [KO] 위에라는 의미를 가집니다. 예를 들어 헬리콥터.
across : [EN] Across 무엇 무엇을 가로질러라는 뜻이에요. Be careful The Road 길을 건널 때는 조심하세요라는 의미입니다. ; [KO] 어크로스 무엇무엇을 가로질러 나는 뜻이에요 BTS world 길을 건널 때는 조심하세요라는 의미입니다.
action : [EN] 액션 행동 또는 조치라는 뜻의 명사입니다. The movie was full of ation. 그 영화는 액션으로 가득했다. ; [KO] 또는라는 뜻의 명사입니다. 그 영화는 액션으로 가득했다. 이름이래요.
activity : [EN] Activity. We did a fun activity in class today. ; [KO] Activity. We did a fun activity in class today.
actor : [EN] For actor 남자배우를 뜻하는 단어입니다. 제가 가장 좋아하는 배우는 톰 행크스입니다라는 의미네요. ; [KO] 남자를을 뜻하는 단어입니다. My favorite restaurant. 제가 가장 좋아하는 배우는 톰행크스입니다. 나는 이네요.
actress : [EN] 액트스 여자배우를 의미합니다. 그녀는 재능 있는 여배우이다라는 의미입니다. ; [KO] Actress. She is a talented actress.
add : [EN] At. Please add some sugar to my coffee. ; [KO] 토하다 너는 커피에 설탕을 좀 넣어 주세요 나는 임입니다.
address : [EN] Address. What is your home address? ; [KO] Address. What is your home address?
adult : [EN] Adult 성인 또는 어른을 의미합니다. You mus be on to watch this movie이 영화를 보려면 성인이어야 합니다라는 의미가 됩니다. ; [KO] 성인 도는 어른을 의미합니다. Uspa 성인이어야 합니다.
advice : [EN] Advice 조언 또는 충고라는 뜻의 명사입니다. 저에게 조언 좀 해주실 수 있나요라는 의미입니다. ; [KO] Advice to one. Can you give me some advice?
afraid : [EN] Afraid. I'm afraid of spiders. ; [KO] Afraid to do what I'm afraid of spiders.
after : [EN] After 무엇 무엇 후에라는 뜻을 가집니다. Let's meet after school. 방과 후에 만나자라는 의미입니다. ; [KO] After More Time to go. 방과 후에 만나자 나는 의미입니다.
afternoon : [EN] Afternoon, I will see you this afternoon. ; [KO] Afternoon 오후입니다 오늘 오후에 뵐게요.
again : [EN] Again. Can you say that again, please? ; [KO] Again. Text to Tristan. Can you say that again, please?
age : [EN] Age. What is your age? ; [KO] 에이즈라는 뜻의 명사입니다. 부르면 나이가 어떻게 되세요라는 뜻입니다.
ago : [EN] Logo. 1 more CH brilliant. She left a long time ago. ; [KO] One more time long time ago.
agree : [EN] Agree 동의하다라는 뜻의 동사입니다. I agree with you. 당신 의견에 동의해요라는 의미네요. ; [KO] 동의하다라는 뜻의 동사입니다. 동의해요 따름이네요.
air : [EN] Air 공기 또는 하늘이라는 뜻입니다. I need some fr레h Air. 신선한 공기가 필요해요라는 의미네요. ; [KO] 에어 공기 또는 하늘이란 뜻입니다. I need some fresh air. 신선한 공기가 필요해요 놈이네요.
airport : [EN] Airport 공항이라는 뜻의 단어입니다. 비행기를 타려면 공항에 가야 해요라는 의미네요. ; [KO] Airport 공항이라는 뜻의 단어입니다. 비행기를 타려면?
all : [EN] All. Students must attend the meeting. ; [KO] 어 모든 또는 모드로라는 뜻으로 전체를 나타낼 때 사용합니다. 먹자 10일 미팅 모든 학생들은 회의에 참석해야 합니다라는 의미는?
also : [EN] Also 또한 또는 역시라는 뜻으로 무언가를 덧붙여 말할 때 사용합니다. 그녀는 의사이자 작가이기도 하다라는 의미네요. ; [KO] 역시라는 뜻으로 무언가를 덧붙여 말할 때 사용합니다. 의사이자 작가이기도 하다 나는 이네요.
always : [EN] Always 항상 또는 언제나라는 뜻의 부사입니다. He always arrivees on time. 그는 항상 제 시간에 도착한다라는 의미네요. ; [KO] 너는 언제나 나는 부산이다. Sometime 그는 항상 제 시간에 도착한다 놈이네요.
amazing : [EN] Amazing 놀라운 또는 굉장한이라는 뜻으로 아주 좋은 것을 묘사할 때 쓰는 형용세입니다. The View from the top was amazing. 정상에서 본 경치는 정말 놀라웠다라는 의미네요. ; [KO] 놀라운 굉장한이라는 뜻으로 아주 좋은 것을 묘사할때 what 정상에서 본.
and : [EN] N 그리고 또는 무엇 무엇와 플래쉬 맛 대쉬콰라는 뜻으로 단어나 문장을 연결할 때 사용합니다. 나는 빵과 버터를 좋아한다라는 의미네요. ; [KO] N 그리고 또는 무엇 무엇을라는 뜻으로 단어나 문장을 연결할 때 사용합니다. I like her. 나는 방과 버터를 좋아한다라는 의미네요.
angry : [EN] Angry 화난이라는 감정을 나타내는 형용사입니다. She was angry with him. 그녀는 그에게 화가났다라는 의미네요. ; [KO] Angry. She was angry with him.
animal : [EN] Any 동물이라는 뜻의 명사입니다. 걔는 가축이다라는 의미네요. ; [KO] 애니모 동물이라는 뜻의 명사입니다. 걔는 가죽이다 라면.
another : [EN] Another can I have another cup of coffee? ; [KO] Another cup of coffee.
answer : [EN] Answer. I don't know the answer to the question. ; [KO] Enter 명사로는 대답 답 동사로는 대답하자라는 뜻을 가십니다. Torsion 나는 그 질문에 대한 답을 모른다 나는.
any : [EN] 애니 어떤 또는 아무라는 뜻으로 주로 물어보는 문장이나 부정하는 문장에서 쓰입니다. Do you have any questions? 질문 있으신가요라는 의미네요. ; [KO] 아니 어떤 또는 안으로라는 뜻으로 주로 물어보는 문장이나 부정하는 문장에서 쓰입니다. 질문이 있으신가요?
anyone : [EN] Anyone 누군가 또는 아무나라는 뜻으로 사람을 가리킬 때 씁니다. Is anyone home. 집에 누구 있어요라는 의미네요. ; [KO] 애니원 누군가 또는 아무나라는 뜻으로 사람의 그렇게 됐습니다. Home 집에 누구 있어요?
anything : [EN] Anything 무엇이든 또는 아무것도라는 뜻으로 사물을 가리킬 때 사용합니다. Can I get you anything to drink. 마실 것 좀 드릴까요라는 의미네요. ; [KO] 애니씽 무엇이든 아무것도 뜻으로 사물을 가리킬 때 사용합니다. 계란 좀 드릴까요?
apartment : [EN] Apartment 우리가 흔히 말하는 아파트라는 뜻입니다. The liv in a small apartment. 그들은 작은 아파트에 산다라는 의미네요. ; [KO] 펄멘트 우리가 흔히 말하는 란 뜻입니다. 작은 아파트에 산다.
apple : [EN] Apple 과일의 한 종류인 사과라는 뜻입니다. UN apple a day keeps the doctor away. 나는 유명한 속담이 있죠. 하루에 사과 한 개를 먹으면 의사가 필요없다라는 의미네요. ; [KO] Apple 과일의 한 종류인 사과라는 뜻입니다. 유명한 속담이 쳐 하루에 사과 필요 없다. 나는 이네요.
April : [EN] 에이러 원년 중네 번째 달인 for w를 의미합니다. My birthday is in appro. 제 생일은 for 월이에요라는 의미네요. ; [KO] Approve 1년 중네 번째 달인 4월의 합니다. Neversaynever 제 생일은 9월 워리어라는 의미는?
area : [EN] Area. This is a quiet residential area. ; [KO] 지역 또는 구역이라는 뜻의 명사입니다. 주거지역이 다 있네요.
arm : [EN] ARM 우리 몸의 일부인팔이라는 뜻입니다. He broke is ARM playing suer. 그는 축구를 하다가 팔이 부러졌다라는 의미네요. ; [KO] 어 우리 몸의 일부인 8이란 뜻입니다. Procedure parameter. 그는 축구를 하다가 팔 부러졌다. 가는 중이네요.
around : [EN] Around 무엇 무엇 주위에 또는 대략이라는 뜻으로 쓰입니다. We set around the table. 우리는 table 주위에 앉았다라는 의미네요. ; [KO] Grand mother 또는 대략이라는 뜻으로 쓰입니다. 우리는 테이블 주위에 앉았다 따름이네요.
arrive : [EN] Arrived. What time does the train arrived? ; [KO] Paris 도착하다 합니다. Weather is. 기차는 몇 시에 도착하나요라는 의미는?
art : [EN] Art 예술 또는 미술이라는 뜻의 명사입니다. I enjoy visiting ares. 저는 미술관 가는 것을 즐겨요라는 의미네요. ; [KO] RT 예술 또는 미술관 가는 것을 즐겨요.
article : [EN] Artical 신문이나 잡지에 실린 기사라는 뜻과 문법에서 a an 더와 같은 관사라는 뜻을 가지고 있습니다. 오늘 신문에서 흥미로운 기사를 읽었다라는 의미네요. ; [KO] 빨리 클 신문이나 잡지 애슬린 기사 치과 문법에서 anwar 같은 반 사 가지고 있습니다. 오늘 신문에서 흥미로운 기사를 읽었다라는 의미는?
artist : [EN] Artist. Van Gogh is a famous artist. ; [KO] 예술가 또는 화가라는 뜻입니다. 유명한 화가이다.
as : [EN] As. He works as a teacher. ; [KO] 110 store. He works at a teacher without a story.
ask : [EN] Ask. Can I ask you a question? ; [KO] 아크 문자 또는 질문하다라는 뜻의 동사입니다. 질문 하나 해도 될까 나는 이네요.
at : [EN] 앱 특정 장소나 시간을 나타내는 무엇? 무엇에? 엠바에 엠바이에 엠바이에 엠바이 예 예 엠바예 엠바이예 엠바이예 엠바이예 엠바이에 엠바이에 엠바이에 엠바이에! ; [KO] 특정 병점 NBA NBA NBA NBA NBA NBA NBA NBA NBA NBA NBA NBA.
August : [EN] August. 8 to water. We are going on vacation in August. ; [KO] We are going on vacation in August.
aunt : [EN] 앤트, 이모, 고모, 숙모 등 부모님의 여자 형제를 부르는 말입니다. 나의 이모는 캐나다에 사신다라는 의미네요. ; [KO] MT 이모, 승모 등 부모님이 여자형제를 부르는 말입니다. Mindwave canada 나의 이모는 캐나다.
away : [EN] Away 떨어져 또는 멀리라는 뜻으로 현재 위치에서 벗어나는 것을 의미합니다. 저리 가서 나를 혼자 있게 해 줘라는 의미네요. ; [KO] 떨어져 멀리 나는 스스로 현재 위치에서 벗어나는 것을 의미합니다. Wales Melon 혼자 있게 해 줘 나는 이네요.
awesome : [EN] 어썸 굉장한 또는 아주 멋진이란 뜻으로 어메이징과 비슷하게 감탄을 표현할 때 사용합니다. The View from the mounta was aesome라는 의미네요. ; [KO] 굉장한 돈은 아주 멋진이란 뜻으로 어메이징 거야. Be When The World of Tom 나는 이네요.
baby : [EN] 베이비 애기라는 뜻의 명사입니다. My sister just had a baby. 누나가 방금 애기를 낳았어요라는 의미네요. ; [KO] 입니다 mister Cheer up baby.
back : [EN] 백 명사로는 등 부사로는 뒤로라는 뜻을 가집니다. 테니스를 치다가 등을 다쳤어요라는 의미네요. ; [KO] 백 명사로는 등 뒤로 난 뜻을 됩니다.
bad : [EN] Bad 나쁜이라는 뜻으로 좋지 않은 상태나 품질을 나타냅니다. This is a bad. Apple이 사과는 썩었다라는 의미네요. ; [KO] 나쁜이라는 뜻으로 좋지 않은 상태나 품질을 나타냅니다. 뜻을 사과는 썩었다 나는 이네요.
bag : [EN] Back 가방이라는 뜻입니다. 이거 제 가방에 좀 넣어 줄래요라는 의미네요. ; [KO] 맥 가방이란 뜻입니다. Knupark 이거 제일 가방이 좀 넣어 줄래요 나는?
ball : [EN] 볼 궁이라는 뜻의 명사입니다. Let's play with the B 공 가지고 놀자 bu라는 의미네요. ; [KO] 도우이라는 뜻의 병사입니다. 가지고 놀자.
banana : [EN] Banana. I eat a banana for breakfast. ; [KO] Banana banana for breakfast.
band : [EN] Band. Bent. My favorite band is playing tonight. ; [KO] Send send my favorite band is playing tonight.
bank (money) : [EN] Thank 돈을 다룬 은행이라는 뜻입니다. I need to go to the bank. 은행에 가야 해요라는 의미네요. ; [KO] I need to go to bank. 은행에 가야 해요.
bar : [EN] 브로버 술집 또는 바라는 뜻입니다. Let's meet the for a drink. 바에서 만나서 한잔 하자라는 의미네요. ; [KO] 술집 타라는 뜻입니다. Weather for 만나서 한잔하자!
baseball : [EN] Baseboard. He loves to play baseball. ; [KO] 메이플 한 종류인 야구라는 뜻입니다. Lovely day for. 그는 야구 하는 것을 아주 좋아한다 나는.
basketball : [EN] Basketball. Let's play basketball after school. Catchy, sir. ; [KO] Black people. What's the 100? Let's play basketball after school.
bath : [EN] That 목욕이란 뜻입니다. I'm going to take a bath. 목욕 좀 해야겠어요라는 의미네요. ; [KO] 가스 목욕이란 뜻입니다. KBS 목욕 좀 해야겠어요 나는 이네요.
bathroom : [EN] Bathroin 화장실 또는 욕실이라는 뜻입니다. 화장실 좀 써도 될까요라는 의미네요. ; [KO] 화장실 욕실 화장실 좀 써도 될까요?
be : [EN] B. I want to be a doctor. ; [KO] One more Statin I want to be a doctor.
beach : [EN] Beach 해변 또는 바닷가라는 뜻입니다. Let's go to the beach. 해변에 가자라는 의미네요. ; [KO] 해변 또는 바닷가라는 뜻입니다.
beautiful : [EN] Beutiful 아름다운이라는 뜻의 형용사입니다. 사람이나 사물, 경치 등이 보기 좋을 때 칭찬하는 의미로 사용합니다. She is a beutiful wom. 그녀는 아름다운 여성이다라는 의미네요. ; [KO] Beautiful 아름다운이라는 뜻의 형용사입니다. 사람이나 사물, 경치 등이 보기 좋을 때 칭찬하는 의미로 사용합니다. 그녀는 아름다운 여성이다라는 의미는?
because : [EN] Becuse 무엇 무엇 때문에라는 뜻으로 이유를 설명할 때 사용하는 접속사입니다. 교통체증 때문에 늦었어요라는 의미네요. ; [KO] Because one more time and I was late because of the traffic to email.
become : [EN] Become. He wants to become a famous singer. ; [KO] Become one more suited to throw. He wants to become a famous singer.
bed : [EN] That 침대라는 뜻의 명사입니다. It's time to go to bed. 자러 갈 시간이야라는 의미네요. ; [KO] 침대라는 뜻의 명사입니다. To bed 자러 갈 시간이야.
bedroom : [EN] Pagro 침실이란 뜻으로 집안의 공간을 설명할 때 사용합니다. My bad room is very small. 제 침실은 매우 작아요라는 의미네요. ; [KO] 대전 침실 2로 집안의 공간을 설명할 때 사용합니다. 많이 verismo 차 가요!
beer : [EN] Bear 술의 한 종류인 맥주라는 뜻입니다. 맥주 한 잔 하시겠어요라는 의미네요. ; [KO] 술의 한 종류인 맥주 많으십니다. 맥주 한잔 하시겠어요?
before : [EN] Before. Please wash your hands before dinner. ; [KO] Before. Walmart tunnel, please wash your hands before dinner.
begin : [EN] Begin 시작하다라는 뜻으로 start와 비슷한 의미를 가집니다. 수업을 시작합시다라는 의미네요. ; [KO] 이젠 시작하다라는 뜻으로 start 와 비슷한 의미를 가집니다. What's the weather forecast? 나는 이네요.
beginning : [EN] Bg밍. 시작이라는 뜻의 명사입니다. This is just begining. 이것은 시작에 불과하다라는 의미네요. ; [KO] 비기닝 시작이라는 뜻의 명사입니다. 메신저 thing 이것은 시작에 불과하다라는 의미는?
behind : [EN] Behind. The cat is behind the tree. ; [KO] Behind will Morty. The cat is behind the tree.
believe : [EN] Believe. I believe you. ; [KO] Believe. I believe you.
below : [EN] 빌로우 아래에라는 뜻으로 above의 반대 의미를 가집니다. 아래 글을 읽어주세요라는 의미네요. ; [KO] 아니 나는 스스로 반대 의미를 가집니다.
best : [EN] 베스트 최고의라는 뜻으로 구드의 최상급 형태입니다. 이것은 내가 먹어본 케이크 중에 최고야라는 의미네요. ; [KO] 최고의 나는 그대의 최소한 그 정도 됩니다. 내가 먹어본 케이크 중에 최고야라는 의미네요.
better : [EN] Better 더 좋은이라는 뜻으로 good의 비교급 형태입니다. 곧 괜찮아지길 바라요라는 의미네요. ; [KO] 터존이라는 뜻으로 비교급 형태입니다. Version 괜찮아지길 바라요.
between : [EN] Between. The pain is between the book and the notebook penny. ; [KO] 비트윈 두개의 사물이나 사람의 중간 위치를 나타냅니다. Talk not Okay 책과 공책 사이에 있다라는 의미는?
bicycle : [EN] My school. I like to ride my bicycle in the park. ; [KO] 자전거 라인 드십니다. 마이크 줄여서 말하기 좀 해요. Water park. 저는 공원에서 자전거 타는 것을 좋아해요라는 의미네요.
big : [EN] 빅 큰이라는 뜻으로 크기나 규모를 나타내는 기본적인 형용사입니다. 저 개는 크다라는 의미네요. Vound or. ; [KO] 큰이란 뜻으로 적에는 크다라는 이네요.
bike : [EN] Bike. Bicycle, he goes to school by bike. ; [KO] 바이크 자전거라는 뜻으로 줄임말입니다. 일상 대화해서는 바이크를 더 자주 사용해요. 키가 크는 자전거를 타고 학교에 간다. 나는 이네요.
bill : [EN] 계산서 또는 청구서라는 뜻입니다. Can I have the Bill Please 계산서 좀 갖다 주시겠어요라는 의미네요. ; [KO] Bill can I have the bill please get Uncle from Kentucky skip sale.
bird : [EN] Bird. Tired. A bird is singing in the tree. ; [KO] Bird, bird is singing in the tree.
birthday : [EN] Birthday 생일이라는 뜻입니다. Happy birthday to you 생일 축하해요라는 의미입니다. ; [KO] 걸스데이 생일이란 뜻입니다. 생일 축하해요라는 의미입니다.
black : [EN] Black 검은색의 또는 검은색이라는 뜻입니다. 그녀는 긴 검은 머리를 가지고 있다라는 의미네요. ; [KO] Walk 검은색 또는 검은색이라는 됐습니다. 긴 검은머리를 가지고 있다라는 의미네요.
blog : [EN] 블로그 온라인에 개인의 생각이나 경험을 기록하는 블로그라는 뜻입니다. I w The Block about my travels. 저는 제 여행에 대한 블로그를 써요라는 의미네요. ; [KO] 온라인의 개인의 생각이나 경험을 기록하는 블로그라는 뜻입니다. 저는 제 여행에 대한 블록을 했어요. 나는 이네요.
blond : [EN] Blonde. She has blonde hair and blue eyes. ; [KO] Blond she has blonde hair and blue eyes, female?
blue : [EN] 블루 파란색에 또는 파란색이라는 뜻입니다. The sky is blue today. 오늘 하늘은 파라타라는 의미네요. ; [KO] 블루 파란색의 도는 파란색이라는 뜻입니다. 블루투데이 오늘 하늘은 팔았다 나는.
boat : [EN] Boat. Port to We crossed the river by boat. ; [KO] Porta bote.
body : [EN] 바디 몸 또는 신체라는 뜻입니다. 엑서사이즈 is good for the body. 운동은 몸에 좋다라는 의미네요. ; [KO] 파리 몸 신체 됐습니다. Side-by 운동은 몸에 좋다 나는 이네요.
book : [EN] 북 check이라는 뜻의 명사입니다. I am reading a good book. 나는 좋은 책을 읽고 있다라는 의미네요. ; [KO] 책 명상이다 나는 좋은 책을 읽고 있다 틱병.
boot : [EN] Boot. I need a new pair of boots for winter. ; [KO] Boot, put a new pair of boots for winter.
bored : [EN] 지루함을 느끼는 또는 심심한이라는 뜻으로 감정을 나타내는 형용사입니다. I'm bord Let's do something. 심심해 뭐 좀 하자라는 의미네요. ; [KO] 지루하면 느끼는 또는 심심한이라는 뜻으로 감정을 나타내는 형용사입니다. 안 보고 뭐 좀 하자 나는 이네요.
boring : [EN] Borning 지루하게 만드는 또는 재미없는이라는 뜻입니다. Mard가 감정을 느끼는 것을 표현한다면 boring은 지루함을 유발하는 대상을 묘사합니다. This movie is so Boring이 영화는 너무 지루하다라는 의미네요. ; [KO] Boring 지루하게 만드는 또는 재미없는이라는 뜻입니다. 몰드가 감정을 느끼는 것 표현한다면 보이는 지루함을 유발하는 대상을 묘사합니다. Google이 영화는 너무 지루하다. 나는 이네요.
born : [EN] Born 태어난이라는 뜻으로 동사 bear의 과거 분사형입니다. 저는 19틴 19틴연에 태어났어요라는 의미네요. ; [KO] 동사 과거 분사형입니다.
both : [EN] Both. Of my parents are teachers. ; [KO] Both of my parents are teachers. Any me now?
bottle : [EN] Ble 병이라는 뜻입니다. Can I have a ble of water. 물 한 병 주시겠어요라는 의미네요. ; [KO] 말로이라는 뜻입니다. 물 한 병 주시겠어요라는 의미는?
box : [EN] UPS box. He put the books in a cardboard box. ; [KO] 수박 상자란 뜻입니다. DFW airport 그냥 책들을 판지 상자에 넣었다라는 놈이네요.
boy : [EN] Cure boy. The boy is playing with his toys. ; [KO] The boy is playing with his toys.
boyfriend : [EN] 보이프렌드 남자친구라는 뜻입니다. 그녀는 남자친구와 영화관에 갈 것이다. 브라이팅라는 의미네요. ; [KO] 보이프렌드 남자친구라면 됐습니다. 남자친구와 영화관에 갈 것이다. 파이팅라는 의미는?
bread : [EN] Bad 땅이라는 뜻입니다. I eat bread for breakfast every morning. 나는 매일 아침 식사로 빵을 먹는다라는 의미네요. ; [KO] 빵이라는 뜻입니다. 나는 매일 아침 식사로 빵을 먹는다.
break : [EN] Break. Be careful not to break the glass. Let's take a short break. ; [KO] Rake get three. Be careful not to break the glass praising ztreet.
breakfast : [EN] Breakest 아침식사라는 뜻입니다. 아침으로 무엇을 드셨어요라는 의미네요. ; [KO] 아침 식사라는 뜻입니다. Weather forecast.
bring : [EN] Bring 가져오다라는 뜻입니다. Please bring your books to class. 수업에 책을 가져오세요라는 의미네요. ; [KO] 가져오다 뜻입니다. 책을 가져오세요 나는.
brother : [EN] Brother 형 오빠 또는 남동생이란 뜻입니다. My brother is older that me. 나의 형은 나보다 나이가 많다라는 의미네요. ; [KO] Brother 오빠 남동생이랑 됐습니다. 나의 형은 나보다 나이가 많다.
brown : [EN] 브라운 갈색액 또는 갈색이란 뜻입니다. He has brown Eyes 그는 갈색눈을 가지고 있다라는 의미네요. ; [KO] 브라운 또는 그런 뜻입니다. 브라운 아이 그런 갈등을 가지고 있다라는 의미네요.
build : [EN] Build 짓다 또는 건설하다라는 뜻입니다. The are going to build a house. 그들은 새 집을 지을 것이다라는 의미네요. ; [KO] 짓다 또는 건설하다라는 뜻입니다. Darling I love you How 그들은 집을 지을 것이다라는 의미네요.
building : [EN] Building. That is the tallest building in the city. ; [KO] 건물이라는 뜻입니다. 저것은 도시에서 가장 높은 건물이잖아.
bus : [EN] Bus bus. I take the bus to school every day. ; [KO] Bus. Do I take the bus to school everyday?
business : [EN] 비즈니스 사업 또는 일이란 뜻입니다. 히브런스 his own비스 그는 자신의 사업을 운영한다라는 의미네요. ; [KO] 사업 또는 일이란 뜻입니다. 됐네 그는 자신의 사업을 운영한다라는 의미네요.
busy : [EN] 비지. 바쁜이라는 뜻입니다. I'm very today. 나는 오늘 매우 바쁘다라는 의미네요. ; [KO] Bebe. I'm very busy today.
but : [EN] But 그러나 또는 하지만 이런 뜻입니다. He is small but strong. 그는 작지만 힘이 세다라는 의미네요. ; [KO] 그러나 하지만이란 뜻입니다. 등 살지만 힘이 세다라는 의미는?
butter : [EN] Btter 버터라는 뜻입니다. 버터 좀 건네 주시겠어요라는 의미네요. ; [KO] 버터라는 뜻입니다. The button 내 줄 수 있어요라는 의미로.
buy : [EN] By 사다 또는 구매하다라는 뜻입니다. 나는 식료품을 좀 사야 한다라는 의미네요. ; [KO] 사라 돈은 구매하자라는 뜻입니다. Inherit 나는 16분 물 좀 사야 한다라는 의미네요.
by : [EN] Possible possible 무엇 무엇에 의해 또는 무엇 무엇으로라는 뜻입니다. 이메일로 저에게 연락하실 수 있습니다라는 의미네요. ; [KO] 파더 이메일로 저에게 연락 하실 수 있습니다라는 의미네요.
bye : [EN] By 헤어질 때 하는 인사 안녕이라는 뜻입니다. 안녕 내일 봐라는 의미네요. ; [KO] 헤어질 때 하는 인사 안녕이라는 뜻입니다. Why you tomorrow? 안녕 내일 봐라는 의미는?
cafe : [EN] 카페라는 뜻입니다. Let's meet the caree. 카페에서 만나요라는 의미네요. ; [KO] As a copy 뜻입니다. SA 카페에서 만나요라는 의미는?
cake : [EN] 케이크 케이크라는 뜻입니다. 그녀는 맛있는 초콜릿 케이크를 구웠다라는 의미네요. ; [KO] 케이크 케이크라는 뜻입니다. Adriatica 그녀는 맛있는 초콜릿 케이크를 구웠다라는 의미는?
call : [EN] 코 부르다 전화하다라는 동사와 전화라는 명사로 쓰입니다. 도착하면 전화해 주세요라는 뜻이고 later told는 나중에 전화할게 PO라는 의미네요. ; [KO] 콜 부르다 전화하다라는 동사와 명사로 쓰입니다. CNN 도착하면 전화해 주세요. 드시고 전화할게.
camera : [EN] 카메라 카메라라는 뜻입니다. 나는 새 디지털 카메라를 샀다라는 의미네요. ; [KO] 몰라 카메라는 뜻입니다. IPhone Camera 나는 디지털카메라.
can : [EN] 캔 무엇 무엇 할 수 있다라는 뜻의 조동사입니다. I can speak English 나는 영어를 할 수 있다라는 의미네요. ; [KO] 할 수 있다. 나는 이제 3주 동생이다. 나는 영어를 할 수 있다.
cannot : [EN] Can not. 무엇 무엇 할 수 없다라는 뜻입니다. Can't로 줄였을 수 있습니다. I can not here you. 당신 말이 들리지 않아요라는 의미네요. ; [KO] 캐나다 무엇 무엇 할 수 없다라는 뜻입니다. 있습니다. I can you 당신 말이 들리지 않아요 나는 이네요.
capital : [EN] 카피로 수도 또는 대문자라는 뜻입니다. 서울은 대한민국의 수도이다라는 의미네요. ; [KO] 잡힐 수도 또는 대문자라는 뜻입니다. 서울은 대한민국.
car : [EN] 컬 자동차라는 뜻입니다. She drivees are. 그녀는 빨간 자동차를 운전한다라는 의미네요. ; [KO] Car 자동차라는 뜻입니다. Radical 그녀는 빨간 자동차를 운전한다.
card : [EN] Card 카드라는 뜻입니다. I sentim Birthday card. 나는 그에게 생일 카드를 보냈다라는 의미네요. ; [KO] Hard code 란 뜻입니다.
career : [EN] 커리어 직업 또는 경력이란 뜻입니다. 그는 의료 분야에서 직업을 갖기를 원한다라는 의미네요. ; [KO] Career 직업 또는 경력이란 뜻입니다. Crimson 의료분야에서 직업을 갖기를 원한다. 나는 이네요.
carrot : [EN] Cat 당근이라는 뜻입니다. 토끼는 당근 먹는 것을 좋아한다라는 의미네요. ; [KO] 당근이라는 뜻입니다. Weathered 쿠키는 당근 먹는 것을 좋아한다 나는 에미넴.
carry : [EN] 캐리 나르다 또는 운반하다라는 뜻입니다이 가방 두는 것 좀 도와줄 수 있어요라는 의미네요. ; [KO] 캐리 마르다 돈은 운반하다 당했습니다이 가방 쓰는 것 좀 도와 줄 수 있어요 나는 이네요.
cat : [EN] Cat 고양이라는 뜻입니다. 우리 집 고양이는 하루 종일 자는 것을 좋아한다라는 의미네요. ; [KO] 고양이라는 뜻입니다. Google Play 우리 집 고양이는 하루 종일 자는 것을 좋아한다. 나는 이네요.
CD : [EN] C, d. Come back to this. I bought a new music, c d. ; [KO] Do comfortable.
cent : [EN] 센트센트라는 뜻의 화폐 단위입니다. This Apple cost 50센ts이 사과는 50센트이다라는 의미네요. ; [KO] 센트 가는 주세요 호텔입니다. 사과는 cm입니다.
center : [EN] 센터 중심 또는 중앙이란 뜻입니다. We liven the시센터 우리는 도심에 산다. Die라는 의미네요. ; [KO] 중심 또는 중앙이란 뜻입니다. Lavender. 우리는 조심해 산다 나의 내미네요.
chair : [EN] Chair. Please take a chair. ; [KO] 의자라는 뜻입니다. Jkr 의자에 앉으세요.
change : [EN] Change. I need to change my clothes. The change in weather was sudden. ; [KO] Change 바꾸다 나는 동사와 변화 거스름돈이라는 명사로 뜁니다. 나는 옷을 갈아 입어야 한다. 드시고 더체인지 with 날씨에 변하는 갑작스럽다 나는 이네요.
chart : [EN] NY chart. The chart shows the company's sales figures. ; [KO] Nice heart tattoo. The chart shows the company's sales figures.
cheap : [EN] 칩 썬 또는 저렴한이라는 뜻입니다. Food이 식당은 음식이 싸고 맛있다라는 의미네요. ; [KO] 쌈 저렴한이라는 뜻입니다.
check : [EN] Check 확인하다 또는 점검하다라는 뜻입니다. 시험지를 제출하기 전에 답을 확인하세요라는 의미네요. ; [KO] 체크 확인하다 또는 점검하다라는 뜻입니다. 프리스트 before he 시험지를 제출하기 전에 확인하세요. 나는 의미네요.
cheese : [EN] 치즈 치즈라는 뜻입니다. I like to eches with crackers. 나는 크래커와 함께 치즈 먹는 것을 좋아한다라는 의미네요. ; [KO] 지 치즈라는 뜻입니다. Likey TWICE 나는 크래커 함께 치즈 먹는 것을 좋아한다. 나는 놈이네요.
chicken : [EN] 치킨 닭 또는 닭고기라는 뜻입니다. We are having rost chicken for dinner. 우리는 저녁으로 구운 닭고기를 먹을 것이다라는 의미네요. ; [KO] Chicken, we are having roast chicken for dinner.
child : [EN] 좋아요드 I 또는 어린이라는 뜻입니다. 복수영은 child입니다. Every Child Need Love an care. 모든 어린이는 사랑과 보살 이 필요하다라는 이네요. ; [KO] 에이치 디엠 아이 또는 어린이라는 뜻입니다. 복수형은 충돌입니다. Everyone is love. 모든 어린이는 사랑과 보살핌이 필요하다. 나는 이민헤어.
chocolate : [EN] Chocate 초콜릿이란 뜻입니다. 초콜릿 한 조각 드시겠어요라는 의미네요. ; [KO] 초콜릿이 안 되십니다. 무주중학교 초콜릿 한 조각 드시겠어요 나는 이네요.
choose : [EN] Choose. you can choose any book, you like, ; [KO] Choose. you can choose any book, you like,
city : [EN] 도시리 도시라는 뜻입니다뉴 York is a very big City 뉴욕은 매우 큰 도시이다라는 의미네요. ; [KO] 2시이라는 뜻입니다. 뉴욕은 매우 큰 도시이다라는 의미.
class : [EN] Class. I have an English class at 10:00 a.m. ; [KO] Classic. I have an English class at 10 a.m.
classroom : [EN] Classro 교실이라는 뜻입니다. The students are in the classro. 학생들은 교실에 있다라는 의미네요. ; [KO] Colostrum 교실이라는 뜻입니다. 학생들은 교실에 있다라는 이네요.
clean : [EN] 그린 깨끗한 이즈이라는 형용사와 청소하다라는 동사로 쓰입니다. Your room is very creen cream. 어쨌든 내 방은 매우 깨끗하다라는 뜻이고. Please clean your room은 방 좀 청소해라라는 의미네요. ; [KO] Green 깨끗한 입이라는 형용사와 청소하다 동사로 쓰입니다. Green green station. 내 방은 나는 드시고 your room in 방 좀 청소 해라 나는 이네요.
climb : [EN] 클라임 오르다 또는 등반하다라는 뜻입니다. 그는 등산하는 것을 좋아한다라는 의미네요. ; [KO] 오르다 또는 등반하다라는 뜻입니다. 등산하는 것을 좋아한다.
clock : [EN] 클락 시계라는 뜻입니다. The clock on the wall It's 10lock 벽식에는 10 c를 가리키고 있다. 라는 의미네요. ; [KO] Clock the clock on the wall says it's 10 p.m. in 10.
close : [EN] Close. Please close the door. ; [KO] Please close the door when you're done.
clothes : [EN] Close 오시라는 뜻입니다. 항상 복수용으로 씁니다. 나는 빨래를 해야 한다라는 의미네요. ; [KO] 클라우드 뜻입니다. 항상 복수형으로 씁니다. I need to small. 나는 빨래를 해야 한다라는 이네요.
club : [EN] Club. Club. He joined the school's chess club. ; [KO] Stop clock.
coat : [EN] Quote quote, it's called outside. So where your coat ; [KO] 클라우드 코트 웹툰 안 되십니다. Cold outside werk 추우니 코트를 입어라.
coffee : [EN] 커피 커피라는 뜻입니다. 나는 매일 아침 커피 한 잔을 마신다라는 의미네요. ; [KO] 커피 커피 만드십니다. 나는 마신다.
cold : [EN] 콜드 추운이라는 형용사와 감기라는 명사로 쓰입니다. The weather is very cold today. 오늘 날씨가 매우 춥다라는 뜻이고. I think I have a cold SW many siries. 탐기에 걸린 것 같다라는 의미네요. ; [KO] Call to one이라는 형용사와 감기라면 그렇습니다. We are very cold today. 오늘 날씨가 매우 춥다 나는 드시고. I can I have cold Spring Tiles 감기에 걸린 것 같다라는 의미 내야.
college : [EN] 컬리지 대학이라는 뜻입니다. 그녀는 대학에서 미술을 공부하고 있다라는 의미네요. ; [KO] College 대학이라는 뜻입니다. 그녀는 대학에서 미술을 공부하고 있다. 나는 이네요.
color : [EN] 컬러 색도는 색깔이란 뜻입니다. What is your favor? 가장 좋아하는 색깔은 무엇인가요라는 의미네요. ; [KO] Cover 색소는 색깔이 란 뜻입니다. Water 가장 좋아하는 색깔은 무엇인가요?
come : [EN] 컴 오다라는 뜻입니다. Can you come to my party. 제 파티에 올 수 있나요라는 의미네요. ; [KO] 컴 오다라는 뜻입니다. Country 있나요?
common : [EN] Com은 흔한 또는 공통의 apv라는 뜻입니다. It's a common Mistake 그것은 흔한 실수이다라는 의미네요. ; [KO] 커먼 크면 또는 공통의 네이티브라는 뜻입니다. Commute 그것은 흔한 실수이다.
company : [EN] Company 회사란 뜻입니다. He works for a large softare company. 그는 큰 소프트웨어 회사에서 일한다라는 의미네요. ; [KO] Turn on the control plan.
compare : [EN] Compare 비교하다라는 뜻입니다. Let's C care prices before we by. 사기 전에 가격을 비교해 봅시다라는 의미네요. ; [KO] Compare burnt 있습니다 retail price for wifi 가격을 비교해 봅시다.
complete : [EN] Complete. The set is now complete. You need to complete the form complete the form. Dylan will error. ; [KO] Complete. Does that is now complete. You need to complete the form complete the form.
computer : [EN] Computer. Computer. I use my computer for work and study. ; [KO] 컴퓨터를 안 됐습니다. 아이유 my computer for easy. 나는 일과 공부를 위해 컴퓨터를 사용한다. 나는 이네요.
concert : [EN] Consert consert 또는 음악회라는 뜻입니다. We W to a Rock concert last night. 우리는 어젯밤 Rock 콘서트에 갔다라는 의미네요. ; [KO] 음악 듣습니다 control unit. 우리는 어젯밤 콘서트에 갔다라는 의미네요.
conversation : [EN] 컨버세이션 대화라는 뜻입니다. I have a long conversation with my friend. 나는 친구와 긴 대화를 나누었다. 라는 의미네요. ; [KO] Conversation 대화라는 뜻입니다. Compressor and. 나는 친구와 긴 대화를 나누었다.
cook : [EN] 크게 요리하다라는 뜻입니다. 아버지는 가족을 위해 저녁을 요리하는 것을 좋아하신다라는 의미네요. ; [KO] 크게 요리하다라는 뜻입니다. Delivery 아버지는 가족을 위해 저녁을 요리하는 것을 좋아하신다라는 의미.
cooking : [EN] 쿠킹 요리라는 뜻입니다. She is very good at cooking. 그녀는 요리를 매우 잘한다라는 의미네요. ; [KO] 쿠킹 요리라는 뜻입니다. Cargo tracking. 그녀는 요리를 매우 잘한다 나는 중이네요.
cool : [EN] 쿨 시원한 또는 멋진 6이란 뜻입니다. 시원한 저녁이다라는 뜻이고 That's조차 정말 멋지다라는 의미네요. ; [KO] 멋진 I am a student 저녁이다 나는 드시고 taken taken 접사 정말 멋지다라는 의미네요.
correct : [EN] Correct. That is the correct answer. Please correct your mistakes correct. ; [KO] 크래프트 정확한이라는 형용사와 수정하다라는 동사로 쓰입니다. Dance practice collectivity 시청하세요.
cost : [EN] Cost. What is the cost of this shirt? Price. ; [KO] 카트 비용 가격이라는 명사와 비용이 들더라는 동사로 쓰입니다. 월드컵점 되시고 corporate towers.
could : [EN] Could 캔의 과거형 또는 공손한 요청을 나타내는 조동사입니다. Could Please help me. 저 좀 도와주시겠어요라는 의미네요. ; [KO] 크루즈 can의 과거형 또는 공손한 요청을 나타내는 부동산입니다. Home 좀 도와주시겠어요 나는 이네요.
country : [EN] Country. France is a beautiful country. France. ; [KO] Country France is a beautiful country from TuneIn.
course : [EN] 코스 과정 또는 강좌라는 뜻입니다. I am taking a Course in computer science. 나는 컴퓨터와 과학 강좌를 듣고 있다라는 의미네요. ; [KO] 콜 과정 또는 강좌라는 뜻입니다. I am taking a car insurance. 나는 컴퓨터 강좌를 듣고 있다라는 놈이네요.
cousin : [EN] 사촌이란 뜻입니다. 나의 사촌과 나는 동갑이다라는 의미네요. ; [KO] 40분이란 뜻입니다. 나의 사춘기 나는 동갑이다 나는 이민헤어.
cow : [EN] 카카오 소우 또는 암소라는 뜻입니다. The cow is eating in the. 소가 들판에서 풀을 듣고 있다라는 의미네요. ; [KO] 수 있습니다. Calling regents Park 소가 풀을 뜯고 있다라는 이네요.
cream : [EN] Cream cream. I like a cream in my coffee. ; [KO] Cream cream. I like a cream in my coffee.
create : [EN] Create 창조하다 또는 만들다라는 뜻입니다. The artist will create beutiful paing. 그 예술가는 아름다운 그림을 창조할 것이다라는 의미네요. ; [KO] Create 창조하다 돈은 만들다 란 뜻입니다네. 그 예술가는 아름다운 그림을 창조할 것이다라는 의미네요.
culture : [EN] Culture 문화라는 뜻입니다. 나는 다른 문화에 대해 배우는 것에 관심이 있다라는 의미네요. ; [KO] 습니다 interactive 나는 다른 문화에 대해 배우는 거지 관심이 있다. 나는 이네요.
cup : [EN] 컵 컵 또는 잔이라는 뜻입니다. Would you like a c. 차 한 잔 하시겠어요라는 의미네요. ; [KO] 컵 컵 또는 잔 이런 뜻입니다. 우주라이크 커피 한잔 하시겠어요라는 의미네요.
customer : [EN] Customer 고객 또는 손님이라는 뜻입니다. 손님은 왕이다라는 의미네요. ; [KO] 카처 고객 또는 손님이라는 뜻입니다. 손님은 왕이다 나는 이네요.
cut : [EN] 컷 자르다 또는 베다라는 뜻입니다. Be careful the paper. 종이를 자를 때 조심하세요라는 의미네요. ; [KO] 다르다 돈은 배다 뜻입니다.
dad : [EN] That 아빠라는 뜻입니다. My that is a doctor. 우리 아빠는 의사이다라는 의미네요. ; [KO] 아빠라는 뜻입니다. 닥터 우리 아빠는 의사이다 나는 이민 해요.
dance : [EN] 댄스 춤이라는 명사와 춤추다라는 동사로 쓰입니다. Let's go for a dance이는 춤추러 가자라는 뜻이고 do want dance with me는 나와 춤추시겠어요라는 의미네요. ; [KO] 리엔 취미라는 명사와 춤추다 나는 동사로 쓰입니다. Let's talk in 춤추러가자 그러면 드시고 donten 나와 충주시 했어요.
dancer : [EN] Anser 댄서 또는 무용수란 뜻입니다. She is a professional danser. 그녀는 전문판례 무용수이다라는 의미네요. ; [KO] Answer to 92. M is a professional ballet dancer.
dancing : [EN] 댄싱 춤추기라는 뜻입니다. I love Dancing 나는 춤추는 것을 아주 좋아한다라는 의미네요. ; [KO] 땡땡 춤추기라는 뜻입니다. I love dance. 나는 춤추는 것을 아주 좋아한다. 나는 원이네요.
dangerous : [EN] Dangous 위험한이란 뜻입니다. It is dang to swim in this river이 강에서 수영하는 것은 위험하다라는 의미네요. ; [KO] Hangout 위험함이란 뜻입니다. Industrial Drive 2강에서 지원하는 것은 위험하다. 나는 이네요.
dark : [EN] Dark 어두운이란 뜻입니다. 너무 어두워서 아무것도 볼 수 없다라는 의미네요. ; [KO] 어두운이란 뜻입니다. Stork 너무 어두워서 아무것도 볼 수 없다라는 의미네요.
date : [EN] Date 날짜 또는 데이트라는 뜻입니다. What is the date today? 오늘 날짜가 며칠인가요라는 의미네요. ; [KO] 날짜 또는 데이트 잘해 드립니다. What day today? 오늘 날짜가 며칠인가요?
daughter : [EN] 도를 딸이란 뜻입니다. 그는 아들 하나와 딸 둘이 있다라는 의미네요. ; [KO] 돌 뜻입니다 the weather. 그는 아들 하나 와 딸 둘이 있다 나는 이네요.
day : [EN] Day 나를 또는 하루라는 뜻입니다. There 7 Days in a week. 일주일은 7이다라는 의미네요. ; [KO] Day 뜻입니다. 일주일은 짧은 일이다 나는 이네요.
dear : [EN] Older deer. She is a very dear friend. ; [KO] 오류 아이디어 진행하는 도는 소중한이란 뜻입니다. 편지 첫머리에서 기도합니다. Over your friend. 그녀는 매우 소중한 친구야 나는 미미네.
